2 2 2 2 2 2 2 2 2 2 2 2 2 2 2 2 2 2 2 2 2 2 2 2 2 2 2 2 2 2 2 2 2 2 2 2 2 2 2 2
2 2 2 2 2 2 2 2 2 2 2 2 2 2 2 2 2 2 2 2 2 2 2 2 2 2 2 2 2 2 2 2 2 2 2 2 2 2 2 2
2 2 2 2 2 2 2 2 2 2 2 2 2 2 2 2 2 2 2 2 2 2 2 2 2 2 2 2 2 2 2 2 2 2 2 2 2 2 2 2
2 2 2 2 2 2 2 2 2 2 2 2 2 2 2 2 2 2 2 2 2 2 2 2 2 2 2 2 2 2 2 2 2 2 2 2 2 2 2 2
2 2 2 2 2 2 2 2 2 2 2 2 2 2 2 2 2 2 2 2 2 2 2 2 2 2 2 2 2 2 2 2 2 2 2 2 2 2 2 2
2 2 2 2 2 2 2 2 2 2 2 2 2 2 2 2 2 2 2 2 2 2 2 2 2 2 2 2 2 2 2 2 2 2 2 2 2 2 2 2
2 2 2 2 4 4 4 4 4 4 4 4 4 4 4 4 4 4 4 4 4 4 4 4 4 4 4 4 4 4 4 4 4 4 4 4 2 2 2 2
2 2 2 2 4 4 4 4 4 4 4 4 4 4 4 4 4 4 4 4 4 4 4 4 4 4 4 4 4 4 4 4 4 4 4 4 2 2 2 2
2 2 2 2 4 4 5 5 5 5 5 5 5 5 5 5 5 5 5 5 5 5 5 5 5 5 5 5 5 5 5 5 5 5 4 4 2 2 2 2
2 2 2 2 4 4 5 5 5 0 0 0 0 0 0 0 0 8 8 8 8 0 0 0 8 8 8 8 0 0 0 5 5 5 4 4 2 2 2 2
2 2 2 2 4 4 5 5 5 0 0 0 0 0 0 0 0 8 8 8 8 0 0 0 8 8 8 8 0 0 0 5 5 5 4 4 2 2 2 2
2 2 2 2 4 4 5 5 5 0 0 0 0 0 0 0 0 8 8 8 8 0 0 0 8 8 8 8 0 0 0 5 5 5 4 4 2 2 2 2
2 2 2 2 4 4 5 5 5 0 0 0 0 0 0 0 0 8 8 8 8 0 0 0 0 0 1 0 0 0 0 5 5 5 4 4 2 2 2 2
2 2 2 2 4 4 5 5 5 0 0 0 0 0 0 0 0 8 8 8 8 0 0 1 1 1 1 0 0 0 0 5 5 5 4 4 2 2 2 2
2 2 2 2 4 4 5 5 5 0 0 0 0 0 0 0 0 0 1 1 1 0 0 1 0 0 0 0 0 0 0 5 5 5 4 4 2 2 2 2
2 2 2 2 4 4 5 5 5 0 0 0 0 0 0 0 0 0 1 1 1 0 0 1 0 0 0 0 0 0 0 5 5 5 4 4 2 2 2 2
2 2 2 2 4 4 5 5 5 0 0 0 0 0 0 0 0 0 1 1 1 1 1 1 0 0 0 0 0 0 0 5 5 5 4 4 2 2 2 2
2 2 2 2 4 4 5 5 5 0 0 0 0 0 0 0 0 0 0 0 0 0 0 0 0 0 0 0 0 0 0 5 5 5 4 4 2 2 2 2
2 2 2 2 4 4 5 5 5 0 0 0 0 0 0 0 0 0 0 0 0 0 0 0 0 0 0 0 0 0 0 5 5 5 4 4 2 2 2 2
2 2 2 2 4 4 5 5 5 0 0 0 0 0 0 0 0 0 0 0 0 0 0 0 0 0 0 0 0 0 0 5 5 5 4 4 2 2 2 2
2 2 2 2 4 4 5 5 5 0 0 0 0 0 0 0 0 0 0 14 14 14 14 0 13 13 0 12 12 0 0 5 5 5 4 4 2 2 2 2
2 2 2 2 4 4 5 5 5 0 0 0 0 0 0 0 0 0 0 14 14 14 14 0 13 13 0 12 12 0 0 5 5 5 4 4 2 2 2 2
2 2 2 2 4 4 5 5 5 0 0 0 0 0 0 0 0 0 0 14 14 14 14 0 13 13 0 12 12 0 0 5 5 5 4 4 2 2 2 2
2 2 2 2 4 4 5 5 5 0 0 0 0 0 0 0 0 0 0 14 14 14 14 0 13 13 0 12 12 0 0 5 5 5 4 4 2 2 2 2
2 2 2 2 4 4 5 5 5 5 5 5 5 5 5 5 5 5 5 5 5 5 5 5 5 5 5 5 5 5 5 5 5 5 4 4 2 2 2 2
2 2 2 2 4 4 5 5 5 5 5 5 5 5 5 5 5 5 5 5 5 5 5 5 5 5 5 5 5 5 5 5 5 5 4 4 2 2 2 2
2 2 2 2 4 4 4 4 4 4 4 4 4 4 4 4 4 4 4 4 4 4 4 4 4 4 4 4 4 4 4 4 4 4 4 4 2 2 2 2
2 2 2 2 4 4 4 4 4 4 4 4 4 4 4 4 4 4 4 4 4 4 4 4 4 4 4 4 4 4 4 4 4 4 4 4 2 2 2 2
2 2 2 2 2 2 2 2 2 2 2 2 2 2 2 2 2 2 2 2 2 2 2 2 2 2 2 2 2 2 2 2 2 2 2 2 2 2 2 2
2 2 2 2 2 2 2 2 2 2 2 2 2 2 2 2 2 2 2 2 2 2 2 2 2 2 2 2 2 2 2 2 2 2 2 2 2 2 2 2